SO ./textures/south.xpm
NO ./textures/north.xpm
WE ./textures/west.xpm
EA ./textures/east.xpm

F 42, 149, 1
C 179, 179, 255

1111111
1000111
1100001
1111111
11
      111111111
     11000000011
    1100000000011
    10001111111111
 11110011        1
110010011        1
110010001111111111
1 101000000000001
11001000000000001
1100100000E000001
11001000000000001
11001000000000001
 1111000011110001
    100001 1000011111
    100001 10000000001
    111111 1111111111