11111111111111111111
10100000000000000001
10110001100000000001
1000N001000111110001
10100001000000000001
10000001000111111001
10000001001000001001
10000000111000001001
10000000000000001001
11111111111111111111