SO ./textures/south.xpm
NO ./textures/north.xpm
WE ./textures/west.xpm
EA ./textures/east.xpm

F 42, 149, 1
C 179, 179, 255

11111111111111111111
10100000000000000001
10110001100000000001
1001N001000111110001
10110001000000000001
10000001000111111001
10000001001000001001
10000000111000001001
10000000000000001001
11111111111111111111