SO ./textures/south.xpm
NO ./textures/north.xpm
WE ./textures/west.xpm
EA ./textures/east.xpm

F 42, 149, 1
C 179, 179, 255

1111
10N1
1001
1111