SO ./textures/south.xpm
NO ./textures/north.xpm
WE ./textures/west.xpm
EA ./textures/east.xpm

F 42, 149, 1
C 179, 179, 255

11111
10001
100N1
10001
11111