SO ./textures/south.xpm
NO ./textures/north.xpm
WE ./textures/west.xpm
EA ./textures/east.xpm
F 240, 221, 151
C 194, 194, 209

        1111111111111111111111111
        100000000011000000000000111111
        1011000001110000000000001
        1001000000000000000000001
111111111011000001110000000000001
100000000011000001110111111111111
11110111111111011100000010001
11110111111111011101010010001
11000000110101011100000010001
10000000000000011001N0010001
10000000100000001101010010001
11000001 10101011111011110011
11110111 1110101 101111010011111
11111111 1111111 111111111111
